#########
##      #
#   .   #
#   $   #
# .$@$. #
####$   #
####.   #
####   ##
#########