##########
#   #    #
# $ $#$  #
# #.@.#  #
# $ $ #  #
#   . .  #
##########
