###########
#     .   #
# ###$### #
# #  $  # #
# #$#@#$# #
#   $.$   #
###########
